11111111111
100PCE00001
100000000C1
11111111111
